                                                  
                                                  
                                                  
                                                  
                                                  
                                                  
            ####################                  
            #                  #                  
          ###                  ###                
          #                      #                
          #                      #                
          #              #       #                
          #              #       #                
          #       ###    #       #                
          #   #   # #    #########                
          #   #   # #      #     #                
          #   #   # #      #     #                
          #   #            #     #                
          #   #            #     #                
          #   #            #     #                
          #   #            ###   #                
          #   #######            #                
          #         #            #                
          #         #            #                
          #         #      #     #                
          #         #      #     #                
          ###########      #     #                
              #            #     #                
              #            #     #                
              #            #     #                
              #    ###############                
              #    #                              
              #    #                              
              ######                              
                                                  
                                                  
                                                  
                                                  
                                                  
                                                  
                                                  
                                                  
                                                  
                                                  
                                                  
                                                  
                                                  
                                                  
                                                  
                                                  
