  ##################  
  #                ###
###                  #
#                    #
#             #      #
#             #      #
#      ###    ########
#   #  # #      #    #
#   #  # #      #    #
#   #           #    #
#   #           #    #
#   #           #    #
#   #           ###  #
#   ######           #
#        #           #
#        #           #
#        #     #     #
#        #     #     #
##########     #     #
    #          #     #
    #          #     #
    #          #     #
    #   ##############
    #   #             
    #####             
