                                        
                                                  
            ##########################            
            #                        #            
            #                        ####         
         ####                           #         
         #                              #         
         #                              #         
         #                   #          #         
         #                   #          #         
         #                   #          #         
         #          ####     ############         
         #     #    #  #        #       #         
         #     #    #  #        #       #         
         #     #    #  #        #       #         
         #     #                #       #         
         #     #                #       #         
         #     #                #       #         
         #     #                #       #         
         #     #                ####    #         
         #     #########                #         
         #             #                #         
         #             #                #         
         #             #                #         
         #             #                #         
         #             #       #        #         
         #             #       #        #         
         #             #       #        #         
         ###############       #        #         
               #               #        #         
               #               #        #         
               #               #        #         
               #               #        #         
               #     ####################         
               #     #                            
               #     #                            
               #######                            
                                                  
                                                  
                                                  
                                                  
                                                  
                                                  
                                                  
                                                  
                                                  
                                                  
                                                  
                                                  
                                                  
                                                  
                                        

